04 04 04 00 00 00 00 00 00 00 00 00 00 00 00 00 00 00 00 00-
06 06 06 07 03 02 00 02 01 01 01 01 01 02 00 00 00 00 00 00-
05 05 05 00 00 01 00 01 00 00 00 00 00 01 00 00 00 00 00 00-
00 02 01 01 01 02 00 01 00 02 01 01 01 02 00 00 00 00 00 00-
00 01 00 00 00 00 00 01 00 01 00 00 00 00 00 00 00 00 00 00-
00 02 01 01 01 01 01 02 00 02 01 01 01 02 00 00 00 00 00 00-
00 00 00 00 00 00 00 00 00 00 00 00 00 01 00 00 00 00 00 00-
00 02 01 01 01 01 01 01 01 01 01 01 01 02 00 00 00 00 00 00-
00 01 00 00 00 00 00 00 00 00 00 00 00 00 00 00 00 00 00 00-
00 01 00 02 01 02 00 02 01 02 00 11 12 13 00 00 00 00 00 00-
00 01 00 01 00 01 00 01 00 02 02 14 15 16 00 00 00 00 00 00-
00 02 01 02 00 02 01 02 00 00 00 17 18 19 00 00 00 00 00 00-
00 00 00 00 00 00 00 00 00 00 00 00 00 00 00 00 00 00 00 00-