44400000000000000000-
66673202111112000000-
55500101000001000000-
02111201021112000000-
01000001010000000000-
02111112021112000000-
00000000000001000000-
02111111111112000000-
01000000000000000000-
01021202120000000000-
01010101021111200000-
02120212000000211120-
00000000000000000000