00000000000000000000-
11111111111111111110-
00000000000000000010-
01111111111111111110-
01000000000000000000-
01000000000111111110-
01111111111100000010-
00000000000000000010-
01111111111111111110-
01000000000000000000-
01111111111111111111-
00000000000000000000