00000000000000000000-
00011101111111000000-
00000101000001000000-
01111101011111000000-
01000001010000000000-
01111111011111000000-
00000000000001000000-
01111111111111000000-
01000000000000000000-
01011101110000000000-
01010101011000000000-
01110111000000000000-
00000000000000000000