04 04 04 00 00 00 00 00 00 00 00 00 00 00 00 00 00 00 00 00 00
06 06 06 07 03 02 00 02 01 01 01 01 01 02 00 00 00 00 00 00 00
05 05 05 00 00 01 00 01 00 00 00 00 00 01 00 00 00 00 00 00 00
00 02 01 01 01 02 00 01 00 02 01 01 01 02 00 00 00 00 00 00 00
00 01 00 00 00 00 00 01 00 01 00 00 00 00 00 00 00 00 00 00 00
00 02 01 01 01 01 01 02 00 02 01 01 01 02 00 00 00 00 00 00 00
00 00 00 00 00 00 00 00 00 00 00 00 00 01 00 00 00 00 00 00 00
00 02 01 01 01 01 01 01 01 01 01 01 01 02 00 00 00 00 00 00 00
00 01 00 00 00 00 00 00 00 00 00 00 00 00 00 00 00 00 00 00 00
00 01 00 02 01 02 00 02 01 02 00 00 00 00 00 00 00 00 00 00 00
00 01 00 01 00 01 00 01 00 02 01 01 01 01 02 00 00 00 00 00 00
00 02 01 02 00 02 01 02 00 00 00 00 00 00 02 01 01 01 02 00 00
00 00 00 00 00 00 00 00 00 00 00 00 00 00 00 00 00 00 00 00 00